2748/2807/2866/2748/2925/2807/2866/2984/2807/2866/2925/2748/2807/2866/2748/
3043/3102/3161/3043/3220/3102/3161/3220/3102/3161/3220/3043/3102/3161/3043/
3279/3338/3338/3279/3338/3338/3338/3338/3338/3338/3338/3279/3338/3338/3279/
3338/3397/3397/3456/3456/3456/3456/3397/3397/3397/3397/3456/3397/3397/3397/
3338/3397/3397/3397/3397/3397/3397/3456/3456/3397/3397/3456/3397/3397/3397/
3515/3456/3456/3397/3397/3397/3397/3456/3397/3397/3397/3456/3397/3397/3397/
3338/3397/3397/3397/3397/3397/3397/3456/3397/3397/3397/3456/3397/3397/3397/
3338/3397/3397/3397/3397/3397/3397/3456/3397/3397/3397/3456/3397/3397/3397/
3338/3397/3397/3397/3397/3397/3397/3456/3397/3397/3456/3397/3397/3397/3397/
3515/3397/3397/3456/3456/3456/3456/3397/3397/3397/3456/3397/3397/3397/3397/
3515/3397/3397/3397/3397/3397/3397/3397/3397/3397/3456/3397/3397/3397/3397/
3338/3397/3397/3456/3456/3456/3456/3456/3456/3456/3456/3397/3397/3397/3397/
3338/3397/3397/3397/3397/3397/3574/3633/3691/3397/3456/3397/3397/3397/3397/
3338/3397/3397/3456/3397/3397/3749/35/94/3397/3397/3456/3397/3397/3397/
3515/3456/3456/3456/3397/3397/153/212/271/3397/3397/3456/3397/3397/3397/
3338/3397/3397/3456/3397/3397/3397/3397/3397/3397/3397/3456/3397/3397/3397/
3338/3397/3397/3456/3456/3456/3456/3456/3456/3456/3456/3456/3397/3397/3397/
3338/3397/3397/3397/3397/3397/3397/3397/3397/3397/3397/3397/3397/3397/3397/
3338/3397/3397/3397/330/3397/3397/3397/3397/3397/330/3397/3397/3397/3397/
3338/3397/3397/3397/389/3397/3397/3397/3397/3397/389/3397/3397/3397/3397/
3338/3397/3397/3397/3397/3397/3397/3397/3397/3397/3397/3397/3397/3397/3397/
3338/3397/3397/3397/3397/3397/448/507/566/3397/3397/3397/3397/3397/3397/
2431/2431/2431/2431/2431/2431/-1/-1/-1/2431/2431/2431/2431/2431/2431/
